"","Matricula","NC","C"
"1","01-000-0257","2","0"
"2","02-001-0200","0","1"
"3","02-001-0209","0","1"
"4","02-002-0344","0","1"
"5","09-011-0587","0","1"
